ashton_2hr	example_input/init/ashton_2hr_clusterassign.txt	example_input/data/ashton_2hr_exprtab.txt
ashton_4hr	example_input/init/ashton_4hr_clusterassign.txt	example_input/data/ashton_4hr_exprtab.txt
ashton_6hr	example_input/init/ashton_6hr_clusterassign.txt	example_input/data/ashton_6hr_exprtab.txt
ashton_8hr	example_input/init/ashton_8hr_clusterassign.txt	example_input/data/ashton_8hr_exprtab.txt
ashton_10hr	example_input/init/ashton_10hr_clusterassign.txt	example_input/data/ashton_10hr_exprtab.txt
ashton_12hr	example_input/init/ashton_12hr_clusterassign.txt	example_input/data/ashton_12hr_exprtab.txt
ashton_14hr	example_input/init/ashton_14hr_clusterassign.txt	example_input/data/ashton_14hr_exprtab.txt
ashton_16hr	example_input/init/ashton_16hr_clusterassign.txt	example_input/data/ashton_16hr_exprtab.txt
ashton_18hr	example_input/init/ashton_18hr_clusterassign.txt	example_input/data/ashton_18hr_exprtab.txt
ashton_20hr	example_input/init/ashton_20hr_clusterassign.txt	example_input/data/ashton_20hr_exprtab.txt
ashton_22hr	example_input/init/ashton_22hr_clusterassign.txt	example_input/data/ashton_22hr_exprtab.txt
ashton_24hr	example_input/init/ashton_24hr_clusterassign.txt	example_input/data/ashton_24hr_exprtab.txt
ashton_30hr	example_input/init/ashton_30hr_clusterassign.txt	example_input/data/ashton_30hr_exprtab.txt
ashton_36hr	example_input/init/ashton_36hr_clusterassign.txt	example_input/data/ashton_36hr_exprtab.txt
ashton_42hr	example_input/init/ashton_42hr_clusterassign.txt	example_input/data/ashton_42hr_exprtab.txt
ashton_48hr	example_input/init/ashton_48hr_clusterassign.txt	example_input/data/ashton_48hr_exprtab.txt
ashton_54hr	example_input/init/ashton_54hr_clusterassign.txt	example_input/data/ashton_54hr_exprtab.txt
ashton_60hr	example_input/init/ashton_60hr_clusterassign.txt	example_input/data/ashton_60hr_exprtab.txt
ashton_66hr	example_input/init/ashton_66hr_clusterassign.txt	example_input/data/ashton_66hr_exprtab.txt
ashton_72hr	example_input/init/ashton_72hr_clusterassign.txt	example_input/data/ashton_72hr_exprtab.txt
